the Arena
###############
#D           D#
#             #
#            D#
#             #
#             #
#             #
#             #
#             #
#             #
#             #
#             #
#   D         #
#             #
###############

